공민석	시험은 원래 일단 보고 조짐당해보는 겁니다.	5
강민호	너네 나 못이겨.	5
김규법	치킨은 살 안쪄. 살은 내가 쪄.	5
김민영	디저트 카페 추천드려요!(추천 안함)	5
김윤하	이길 수 없다면 합류하자.	5
김도익	최고의 가라는 FM이다.	5
유태우	차를 발로 차면? 카놀라유 엌ㅋㅋㅋ	5
김찬수	점심은 나가서 먹지 말고 집에서 먹자.	5
김창연	(조용히 블루투스 동글이를 빼간다.)	5
나은수	아~ 나이 많은 사람들이랑 같이 못하겠다.	5
송윤수	아는 만큼 보인다!!	5
어우석	이씨 가문은 망한 가문이다.	5
이진우	진실의 방으로.	5
이찬혁	안녕하세요. 이찬혁인데요, 사랑합니다.	5
엄종하	헉!	5
정재호	이 게임은 망했어. 이건 이제 맨체스터 유나이티드 팬게임이다.	5
주진수	윤Thㅜ야..	5
최희지	마녀의 샘 아시는구나! 진짜 갓겜입니다.	5
최연철	탄소 함유량 0.01% 이하의 무른 철. 무르고 전성과 연성이 크며, 자기를 띠기도 쉬우나 잃기도 쉽다.	4
홍성재	형이 뭘 알아요.	5
최선문	중요한 것은 꺾이지 않는 마음.	1